UL......UR
..........
..........
..........
..........
..........
..........
..........
..........
DL......DR